0 11 0 0 0 0 0 0 0 0 0 0 0 0 0 0 0 0
0 0 0 0 0 0 0 0 0 13 0 0 0 0 0 7 0 0
0 0 0 0 0 0 0 0 0 0 0 0 0 0 0 0 0 0
0 0 7 0 0 0 0 0 0 0 0 0 0 0 0 0 0 0
0 0 0 0 0 0 0 0 0 0 0 0 0 0 0 0 0 0
0 0 0 0 0 0 0 0 0 0 0 0 0 0 0 0 0 0
0 0 0 5 5 5 5 0 5 0 5 5 5 5 0 0 0 0
0 0 0 5 0 0 0 0 13 0 0 0 0 5 0 0 0 0
0 0 0 5 0 0 0 0 0 0 0 7 0 5 0 0 0 11
0 0 0 5 0 0 0 0 0 0 0 0 0 5 0 0 0 0
0 0 0 5 0 7 0 0 0 0 0 0 0 5 0 0 0 0
0 0 0 5 0 0 0 0 3 0 0 0 0 5 0 0 0 0
0 0 0 5 0 0 0 0 0 0 0 0 0 5 0 0 0 0
0 0 0 5 0 0 0 0 0 0 0 0 0 5 0 0 0 0
0 0 0 5 0 0 11 0 0 0 0 0 0 5 0 0 0 0
0 11 0 5 0 0 0 0 0 0 0 7 0 5 0 0 0 0
0 0 0 5 0 7 0 0 0 0 0 0 0 5 0 0 0 0
0 0 0 5 0 0 0 0 0 0 0 0 0 5 0 0 0 0
0 0 0 5 5 5 5 5 5 5 5 5 5 5 0 0 0 0
0 0 0 0 0 0 0 0 0 0 0 0 0 0 0 0 0 0
0 0 0 0 0 0 0 0 0 0 0 0 0 0 0 0 0 0
0 0 0 0 0 0 0 0 0 0 0 0 0 0 0 0 0 0
0 0 0 0 0 0 0 0 0 0 0 7 0 0 0 0 0 0
0 0 0 0 0 0 0 0 0 0 0 0 0 0 0 0 0 0
0 0 0 0 0 0 0 0 0 0 0 0 0 0 0 0 0 0
0 0 7 0 0 0 0 0 0 0 0 0 0 0 0 0 0 0
0 0 0 0 0 0 0 0 0 0 0 0 0 0 0 0 0 0
0 0 0 0 0 0 0 7 0 0 0 0 0 0 0 0 0 0
0 0 0 0 0 0 0 0 0 0 0 0 0 0 0 0 0 0
0 0 0 0 0 0 0 0 0 0 0 0 0 0 0 0 0 0
0 0 0 0 0 13 0 0 0 0 0 0 0 0 0 0 0 0
0 0 0 0 0 0 0 0 0 0 0 0 11 0 0 0 0 0